Dr Soko Stages
Predefined set of stages
--
Stage 1
   #####
   #..x#
   #o..#
   #...#
####...####
#.o......x#
#....@....#
#x......o.#
####...####
   #...#
   #..o#
   #x..#
   #####
--
Stage 2
########
#x.....#
#......#
#.....o########
#.............#
#@........o...#
######........#
     #.......x#
     ##########
--
Stage 3
##############
#..@#........#
#.oo#........#
#..o.o...#.xx#
#........#.xx#
##############
